   0   6   5 999  20  19  24  28   8  12  14   5  45  31  27  11  41  45  42  27
   6   0   2   3 999   3  42  32  21  16  18  45  47  26  21  38  19  12  17  49
   5   2   0  15  11  22  33  23  14  41  11   3  18  47  44  12   7  37   9  23
 999   3  15   0   6  35  40  42  38   6  40  42  14  48  46   5  40  29  20   0
  20 999  11   6   0  29  23  34   4   6  40  16  26  31   8  44  39  26  23  37
  38  18  32  29  41   0  33  15  39   8   4  30  27   6  23  36  21  45  24  22
  20  29  27  23  47  12   0  36  40  11  36   5  17   5  24  31   2   0   0  41
  24  16  30   7  41   7  37   0   7  37   3  33  45   9   9   8  21  38  22  46
   6  30  13  18   0  41  12   5   0  10   9  24  37  48  33  45  41   2   0  41
  36  24  20  46  21  48  49  18  34   0  31  34   3  49  18  38   0  38  27  17
  28  43  48  33   7  21  10  17  13  14   0   9  16  35   1   0  49  19   6  48
   3  24   8  44   9  39   2  45  35  43  43   0  23  37  14   3  48   0   8  18
  30  46  48  31  39  48   9   7  22  22  38  42   0  38  29  40   7   8  41  15
  38   6  11   2  34  22   5  28  46  12  36  25  33   0  19  42  44  16  31  48
  22   1  21  49   7  26  42  39  25  12   0  10   3  19   0  11  38   1  39   5
  23   2  35  32  35  38  26  17   7  32  32  19   4  21  39   0  26  29  18  42
  25   5  34  49  41  12  45  10  18   3  39  23  29  46  37  29   0  49  37  16
  49  43  45  47  16  36   5  38  32   5  34  14   1  16  21  36  13   0  13   5
  35   3  12   8  32  45  13   6  21   8  46  32  31  44  46  22  29  11   0  35
   0  23  16  44   9  42  39   3  24   4  10  45  49  36  13  24  22  18  18   0
